SFFFFFF.FFFFFFD
F..............
F.F.F.F.F.F.F.F
F..............
F.F.F.F.F.F.F.F
F..............
F.F.F.F.F.F.F.F
F..............
F.F.F.F.F.F.F.F
F.......E......
